10 10
OOOOOOOOOO
OWOOOOOOOO
OWOOOOOOWO
OWOOOOOOOO
OOOOOOOOOO
OOOOOOOOOO
OOOOOOOOOO
OOOOOOOOOO
OOOOOOWOOO
OOOOOOOOOO
